111111111111111111111111111111111111
1CCCCCCC000000000CCCCCC0000000000001
1CCCCCC000000000000000000C000000CC01
10000000CCCC000000P00000000000000001
1000000E00000C00000C000C000000000001
111111111111111111111111111111111111