111111111111111111111111111111111111
111111111111111111111111111111111111
111111111111111111111111111111111111
1CCCCCCC111110000CCCCCC0000000000111
1CCCCCC000000111111000000C000001CC11
10000000CCCC000000P11110000000000111
10000001C00001110010000CCCCCC1111111
1000001E10000C00000C000C111111111111
111111111111111111111111111111111111